###################
#        #        #
# ## ### # ### ## #
#                 #
# ## # ##### # ## #
#    #   #   #    #
#### ### # ### ####
   # #       # #
#### # ## ## # ####
       #   #
#### # ##### # ####
   # #       # #
#### ### # ### ####
#    #   #   #    #
# ## # ##### # ## #
#                 #
# ## ### # ### ## #
#        #        #
###################
